token = redacted
owner = redacted
prefix = "ducc"
game = "Watching Top 10 Fortnite Clips"
status = IDLE
songinstatus = true
altprefix = "@mention"
success = "ðŸŽ¶"
warning = "ðŸ’¡"
error = "ðŸš«"
loading = "âŒš"
searching = "ðŸ”Ž"
help = help
npimages = true
stayinchannel = true
maxtime = 0
alonetimeuntilstop = 0
playlistsfolder = Playlists
updatealerts = true
lyrics.default = "A-Z Lyrics"
aliases {
  // General commands
  settings = [ status ]

  // Music commands
  lyrics = []
  nowplaying = [ np, current ]
  play = []
  playlists = [ pls ]
  queue = [ list ]
  remove = [ delete ]
  scsearch = []
  search = [ ytsearch ]
  shuffle = [ mix ]
  skip = [ voteskip ]

  // Admin commands
  prefix = [ setprefix ]
  setdj = [ setdj ]
  settc = [ chat ]
  setvc = [ voice ]

  // DJ Commands
  forceremove = [ forcedelete, modremove, moddelete ]
  forceskip = [ modskip ]
  movetrack = [ move ]
  pause = [djpause]
  playnext = [djnext]
  repeat = [djloop]
  skipto = [ jumpto ]
  stop = [djquit]
  volume = [ vol ]
}
eval=false